13 13 13 13 13 13 13 13 13 13 13 13 13 13 13 13 13 13 13 13 13 13 13 13 13 13 13 13 13 13
13 13 13 13 13 13 13 13 13 13 13 13 13 13 13 13 13 13 13 13 13 13 13 13 13 13 13 13 13 13
13 13 13 13 13 13 13 13 13 13 13 13 13 13 13 13 13 13 13 13 13 13 13 13 13 13 13 13 13 13
13 13 13 13 13 13 13 13 13 13 13 13 13 13 13 13 13 13 13 13 13 13 13 13 13 13 13 13 13 13
13 13 13 13 6 1 1 1 1 1 1 1 1 1 1 1 5 13 13 13 13 13 13 13 13 13 13 13 13 13
13 13 13 13 2 0 0 0 0 0 0 0 0 0 0 0 3 13 13 13 13 13 13 13 13 13 13 13 13 13 
13 13 13 13 2 0 12 4 4 4 4 4 4 4 9 0 3 13 13 13 13 13 6 1 1 1 1 1 5 13
13 13 13 13 2 0 3 13 13 13 13 13 13 13 2 0 3 13 13 13 13 13 2 0 0 0 0 0 3 13
13 13 13 13 2 0 3 13 13 13 13 13 13 13 2 0 3 13 13 13 13 13 2 0 12 4 9 0 3 13
13 13 13 13 2 0 3 13 13 13 13 13 13 13 2 0 3 13 13 13 13 13 2 0 3 13 2 0 3 13
13 13 13 13 2 0 3 13 13 13 13 13 13 13 2 0 3 13 13 13 13 13 2 0 3 13 2 0 3 13
13 13 13 13 2 0 3 13 13 13 13 13 13 13 2 0 3 13 13 13 13 13 2 0 3 13 2 0 3 13
13 13 13 13 2 0 3 13 13 13 13 13 13 13 2 0 3 13 13 13 13 13 2 0 3 13 2 0 3 13
13 13 13 13 2 0 3 13 13 13 13 13 13 13 2 0 3 13 13 13 13 13 2 0 3 13 2 0 3 13
13 13 13 13 2 0 3 13 13 13 13 13 13 13 2 0 3 13 13 13 13 13 2 0 3 13 2 0 3 13
13 13 13 13 2 0 3 13 13 13 13 13 13 13 2 0 3 13 13 13 13 13 2 0 3 13 2 0 3 13
13 13 13 13 2 0 3 13 13 13 13 13 13 13 2 0 3 13 13 13 13 13 2 0 3 13 2 0 3 13
13 13 13 13 2 0 3 13 13 13 13 13 13 13 2 0 11 1 1 1 1 1 10 0 3 13 2 0 3 13
13 13 13 13 2 0 3 13 13 13 13 13 13 13 2 0 0 0 0 0 0 0 0 0 3 13 2 0 3 13
13 13 13 13 2 0 3 13 13 13 13 13 13 13 8 4 4 4 4 4 4 4 4 4 7 13 2 0 3 13
13 13 13 13 2 0 3 13 13 13 13 13 13 13 13 13 13 13 13 13 13 13 13 13 13 13 2 0 3 13
13 13 13 13 2 0 3 13 13 13 13 13 13 13 13 13 13 13 13 13 13 13 13 13 13 13 2 0 3 13
13 13 13 13 2 0 3 13 13 13 13 13 13 13 13 13 13 13 13 13 13 13 13 13 13 13 2 0 3 13
13 13 13 13 2 0 3 13 13 13 13 13 13 13 13 13 13 13 13 13 13 13 13 13 13 13 2 0 3 13
13 13 13 13 2 0 3 13 13 13 13 13 13 13 13 13 13 13 13 13 13 13 13 13 13 13 2 0 3 13
13 13 13 13 2 0 11 1 1 1 1 1 1 1 1 1 1 1 1 1 1 1 1 1 1 1 10 0 3 13
13 13 13 13 2 0 0 0 0 0 0 0 0 0 0 0 0 0 0 0 0 0 0 0 0 0 0 0 3 13
13 13 13 13 8 4 4 4 4 4 4 4 4 4 4 4 4 4 4 4 4 4 4 4 4 4 4 4 7 13
13 13 13 13 13 13 13 13 13 13 13 13 13 13 13 13 13 13 13 13 13 13 13 13 13 13 13 13 13 13
13 13 13 13 13 13 13 13 13 13 13 13 13 13 13 13 13 13 13 13 13 13 13 13 13 13 13 13 13 13